Humans: 0
lTTTTTTTTTTTt
L...........R
L...........R
L...........R
L...........R
L.....@.....R
L...........R
L...........R
L...........R
L...........R
dDDDDDDDDDDDr